accuse	/ə'kju:z/	обвинять
acknowledge	/ək'nɒlɪdʒ/	сознавать
alter	/'ɒ:ltə/	изменять(ся)
alteration	/,ɒ:ltə'reɪʃ(ə)n/	изменение
amaze	/ə'meɪz/	изумлять, поражать
amplification	/,amplɪfɪ'keɪʃ(ə)n/	увеличение
amplify	/'amplɪfaɪ/	расширять (-ся)
anxiety	/aŋ'zaɪətɪ/	беспокойство, тревога
anxious	/'aŋkʃəs/	тревожный, беспокойный (о деле, времени)
apprehensive	/,aprɪ'hensɪv/	полный страха, тревоги, предчувствий
astonish	/əs'tɒnɪʃ/	удивлять, изумлять
astonishment	/əs'tɒnɪʃmənt/	удивление, изумление
auxiliary	/ɒ:g'zɪljərɪ/	вспомогательный; помощник
awkward	/'ɒ:kwəd/	неуклюжий, неловкий (о людях, движениях и т. п.)
bargain	/'ba:gɪn/	выгодная покупка; торговаться
beef	/bi:f/	говядина; жаловаться
bid	/bɪd/	предложение цены (обыкн. на аукционе); приказывать
bitter	/'bɪtə/	горький, мучительный; горько; горечь
boil	/bɒɪl/	кипятить(ся), варить(ся); фурункул, нарыв
bounce	/bauns/	прыжок; подпрыгивать; вдруг
bruise	/bru:z/	синяк, кровоподтёк; подставлять синяки
burden	/'bə:dn/	ноша, тяжесть; нагружать; припев, рефрен
cabin	/'kabɪn/	хижина; помещать в тесную комнату, кабину и т. п.
cannon	/'kanən/	пушка, орудие; карамболь (в бильярде); сделать карамболь
cease	/si:s/	переставать, прекращать(ся)
cellar	/'selə/	подвал; хранить в подвале, в погребе
charity	/'tʃarɪtɪ/	милосердие
chill	/tʃɪl/	холод; неприятно холодный; охлаждать
chop	/tʃɒp/	(рубящий) удар; рубить; перемена; обменивать, менять; клеймо, фабричная марка
clap	/klap/	хлопанье; хлопать, аплодировать; триппер; заразить триппером
clause	/klɒ:z/	предложение (являющееся частью сложного предложения)
cohesion	/kəu'hi:ʒən/	сцепление
coil	/kɒɪl/	верёвка, сложенная витками в круг; наматывать, обматывать; суета, шум, суматоха
collapse	/kə'laps/	обвал, разрушение; рушиться, обваливаться
compel	/kəm'pel/	заставлять, принуждать
comprehensive	/,kɒmprɪ'hensɪv/	объемлющий
conceal	/kən'si:l/	скрывать
consistency	/kən'sɪstənsɪ/	последовательность, логичность
consistent	/kən'sɪstənt/	последовательный, стойкий
consonant	/'kɒnsənənt/	согласный звук; созвучный
contractor	/kən'traktə/	подрядчик
controversy	/'kɒntrəvə:sɪ/	спор, ссора
crop	/krɒp/	урожай; собирать урожай
cubicle	/'kju:bɪkl/	небольшая отгороженная спальня в школьном общежитии
curl	/kə:l/	локон; завивать(ся)
datum	/'deɪtəm/	данная величина, исходный факт
debris	/'deɪbri:/	осколки, обломки
deduce	/dɪ'dju:s/	выводить (заключение, следствие, формулу)
devote	/dɪ'vəut/	посвящать, уделять
diminish	/dɪ'mɪnɪʃ/	уменьшать(ся), убавлять(ся)
dip	/dɪp/	жидкость, раствор (для крашения, очистки металла, для уничтожения паразитов на овцах и т. п.); погружать(ся)
disease	/dɪ'zi:z/	болезнь; поражать (о болезни)
dismiss	/dɪs'mɪs/	отпускать (класс и т. п.); команда «разойдись!»
disruption	/dɪs'rʌpʃən/	разрушение
domestic	/dəu'mestɪk/	домашний; прислуга
drone	/drəun/	трутень; жужжать, гудеть
dumb	/dʌm/	немой
ease	/i:z/	покой; успокаивать
embarrassment	/ɪm'barəsmənt/	затруднение
emerge	/ɪ'mə:dʒ/	появляться
encore	/ɒŋ'kɒ:/	бис!; вызов на «бис»; требовать повторения, кричать «бис», вызывать
endure	/ɪn'djuə/	выносить
essence	/'esns/	сущность, существо
estate	/ɪs'teɪt/	сословие
evaporate	/ɪ'vapəreɪt/	испарять (-ся)
eventual	/ɪ'ventʃuəl/	возможный, могущий случиться, эвентуальный
excellence	/'eksələns/	превосходство
excessive	/ɪk'sesɪv/	чрезмерный
exhale	/eks'heɪl/	выдыхать
exile	/'eksaɪl/	изгнание; изгонять
expend	/ɪks'pend/	тратить (on), расходовать
expense	/ɪks'pens/	трата, расход
exploit	/'eksplɒɪt/	подвиг; эксплуатировать
fabulous	/'fabjuləs/	баснословный, мифический, легендарный
fall out		выпадать
fascinate	/'fasɪneɪt/	очаровывать, пленять
fasten	/'fa:sn/	навязывать
faucet	/'fɒ:sɪt/	вентиль
feather	/'feðə/	дичь; украшать(ся) перьями
fee	/fi:/	гонорар, вознаграждение; платить гонорар
fierce	/fɪəs/	свирепый, лютый
flaw	/flɒ:/	трещина, щель, порок (в металле, фарфоре и т. п.); вызывать трещину; порыв ветра
flee	/fli:/	избегать
flour	/'flauə/	мука, крупчатка; посыпать мукой
fore	/fɒ:/	нос, носовая часть судна; передний; впереди
frustrate	/frʌs'treɪt/	расстраивать, срывать (планы)
gauge	/geɪdʒ/	мера, масштаб, размер; измерять, проверять (размер)
genuine	/'dʒenjuɪn/	подлинный, истинный, неподдельный, настоящий
glass	/gla:s/	стекло; вставлять стёкла
gleam	/gli:m/	слабый свет, проблеск, луч; светиться
glimpse	/glɪmps/	мелькание, проблеск; (у)видеть мельком
glint	/glɪnt/	вспышка, сверкание; вспыхивать, сверкать
govern	/'gʌvən/	управлять, править
grain	/greɪn/	зерно; раздроблять
grasp	/gra:sp/	схватывание; схватывать, зажимать (в руке)
grind	/graɪnd/	размалывание; молоть(ся), перемалывать(ся)
grocery	/'grəusərɪ/	бакалейная торговля
handful	/'handful/	пригоршня
harden	/'ha:dn/	делать(ся) твёрдым
hatred	/'heɪtrɪd/	ненависть
herd	/hə:d/	стадо; ходить стадом
holster	/'həulstə/	кобура
hostile	/'hɒstaɪl/	неприятельский, вражеский
hug	/hʌg/	крепкое объятие; крепко обнимать, сжимать в объятиях
humility	/hju(:)'mɪlɪtɪ/	покорность, смирение
hurl	/hə:l/	сильный бросок; метать
hyphen	/'haɪfən/	дефис, соединительная чёрточка; писать через дефис
immense	/ɪ'mens/	огромный, безмерный
immersion	/ɪ'mə:ʃən/	погружение
implication	/,ɪmplɪ'keɪʃən/	вовлечение
imply	/ɪm'plaɪ/	заключать в себе, значить
impose	/ɪm'pəuz/	навязать(ся)
incorporate	/ɪn'kɒ:pərɪt/	соединённый, объединённый; соединять(ся), объединять(ся)
inhabit	/ɪn'habɪt/	жить, обитать, населять
inquire	/ɪn'kwaɪə/	спрашивать, узнавать
intervene	/,ɪntə(:)'vi:n/	вмешиваться
irritable	/'ɪrɪtəbl/	раздражительный
jerk	/dʒə:k/	резкое движение, толчок; резко толкать, дёргать; вялить мясо длинными тонкими кусками
lame	/leɪm/	неубедительный, неудовлетворительный; увечить, калечить; тонкая металлическая пластинка; ламе (парчовая ткань для вечерних туалетов)
lane	/leɪn/	узкая дорога, тропинка, особ. между (живыми) изгородями
latter	/'latə/	недавний
lean	/li:n/	тощий, худой; постная часть мясной туши, постное мясо; наклон
leather	/'leðə/	кожа (выделанная); крыть кожей
lend	/lend/	давать, сообщать, придавать
lid	/lɪd/	крышка, колпак
likelihood	/'laɪklɪhud/	вероятность
limb	/lɪm/	конечность, член (тела); расчленять; лимб, край диска (Солнца, Луны, планет)
lingering	/'lɪŋgərɪŋ/	медлительный
loan	/ləun/	заём; давать взаймы, ссужать
luggage	/'lʌgɪdʒ/	багаж
lung	/lʌŋ/	лёгкое
magnificent	/mag'nɪfɪsnt/	великолепный, величественный
magnify	/'magnɪfaɪ/	увеличивать
magnitude	/'magnɪtju:d/	величина, размеры
malicious	/mə'lɪʃəs/	злобный
mall	/mɒ:l/	(тенистое) место для гулянья
mark down		снизить цену
marvel	/'ma:vəl/	чудо, диво; удивляться, изумляться
midst	/mɪdst/	середина
mindful	/'maɪndful/	помнящий
misconception	/'mɪskən'sepʃən/	неправильное представление
mislead	/mɪs'li:d/	вводить в заблуждение
mortgage	/'mɒ:gɪdʒ/	заклад; закладывать
nephew	/'nevju(:)/	племянник
nestle	/'nesl/	ютиться
nevertheless	/,nevəðə'les/	несмотря на, однако; тем не менее
nexus	/'neksəs/	связь
niece	/ni:s/	племянница
nonetheless	/ˌnənðəˈlɪs/	тем не менее, однако
obey	/ə'beɪ/	повиноваться, подчиняться
oblige	/ə'blaɪdʒ/	обязывать
obliterate	/ə'blɪtəreɪt/	вычёркивать, стирать
obscure	/əb'skjuə/	мрачный, тёмный; затемнять
outlook	/'autluk/	вид, перспектива
outstanding	/aut'standɪŋ/	выдающийся, знаменитый
overcome	/,əuvə'kʌm/	побороть, победить
owe	/əu/	быть должным (кому-л.)
persuade	/pə'sweɪd/	склонить, уговорить (into)
pitch	/pɪtʃ/	смола; смолить; высота (тона, звука и т. п.); разбивать (палатки, лагерь)
poke	/pəuk/	толчок, тычок; мешать (кочергой); мешок
premise	/'premɪs/	(пред) посылка
presumable	/prɪ'zju:məbl/	возможный, вероятный
principal	/'prɪnsəpəl/	глава, начальник; главный, основной
profound	/prə'faund/	глубокий, основательный; глубина, бездна
prone	/prəun/	(лежащий) ничком
prospective	/prəs'pektɪv/	будущий
proverb	/'prɒvəb/	пословица
purposeful	/'pə:pəsful/	целеустремлённый
quiz	/kwɪz/	насмешка; насмехаться или подшучивать (над чем-л.); экзамен; производить опрос
reckless	/'reklɪs/	безрассудный, опрометчивый
reckon	/'rekən/	рассматривать, считать за
refugee	/,refju(:)'dʒi:/	беженец
relief	/rɪ'li:f/	пособие по безработице; рельеф (изображение)
relieve	/rɪ'li:v/	облегчать, уменьшать (тяжесть, давление); делать рельефным
reluctant	/rɪ'lʌktənt/	делающий (что-л.) с неохотой
rend	/rend/	рвать, раздирать, разрывать
retailer	/ri:'teɪlə/	розничный торговец, лавочник
retreat	/rɪ'tri:t/	отступление; уходить, отходить
rubber	/'rʌbə/	резина; покрывать резиной, прорезинивать; роббер
rubbish	/'rʌbɪʃ/	хлам, мусор
sack	/sak/	мешок, куль; класть или ссыпать в мешок; разграбление; грабить; белое сухое вино, импортировавшееся из Испании и с Канарских островов
seize	/si:z/	хватать, схватить
severe	/sɪ'vɪə/	строгий, суровый
sew	/səu/	шить, сшивать, зашивать, пришивать; спускать (воду)
shallow	/'ʃaləu/	мелкий; мелкое место, мель; мелеть
shed	/ʃed/	ронять, терять (зубы, шерсть, волосы, листья); навес, сарай
shove	/ʃʌv/	толчок; пихать
shriek	/ʃri:k/	пронзительный крик, визг; пронзительно кричать, визжать
soar	/sɒ:/	парить, высоко летать
soil	/sɒɪl/	почва, земля; пачкать(ся), грязнить(ся); давать скоту зелёный корм
solitude	/'sɒlɪtju:d/	одиночество
sore	/sɒ:/	болячка, рана, язва; чувствительный, болезненный; жестоко, тяжко
spectacular	/spek'takjulə/	эффектный, импозантный; эффектное зрелище
spew	/spju:/	рвота, блевотина; блевать, изрыгать
spite	/spaɪt/	досаждать, делать назло
stab	/stab/	удар (острым оружием); нападать
stark	/sta:k/	окоченевший, застывший; совершенно, полностью
starve	/sta:v/	умирать от голода
strain	/streɪn/	натяжение, растяжение; натягивать; порода, племя, род
stride	/straɪd/	большой шаг; шагать (большими шагами)
stunt	/stʌnt/	остановка в росте, задержка роста; останавливать рост; удачное, эффектное выступление (на спортивных соревнованиях); демонстрировать смелость, ловкость
summon	/'sʌmən/	вызывать (в суд)
superlative	/sju(:)'pə:lətɪv/	величайший, высочайший; вершина, кульминация, высшая точка
supervision	/,sju:pə'vɪʒən/	надзор, наблюдение
surge	/sə:dʒ/	большая волна; подниматься, вздыматься
suspend	/səs'pend/	вешать, подвешивать
suspense	/səs'pens/	неизвестность, неопределённость
sustain	/səs'teɪn/	поддерживать, подпирать
swirl	/swə:l/	водоворот; кружить(ся) в водовороте
tackle	/'takl/	принадлежности, инструмент; закреплять снастями
tangible	/'tandʒəbl/	осязаемый, материальный; нечто ощутимое, реальное, осязаемое
tangle	/'taŋgl/	спутанный клубок; запутывать(ся), усложнять(ся)
teaser	/'ti:zə/	любитель подразнить
term	/tə:m/	срок, определённый период; выражать, называть
thankful	/'θaŋkful/	благодарный
thirsty	/'θə:stɪ/	томимый жаждой
thorough	/'θʌrə/	полный, совершенный
thoughtful	/θɒ:tful/	задумчивый, погружённый в размышления
thrive	/θraɪv/	процветать, преуспевать
thrust	/θrʌst/	толчок; толкать
tidy	/'taɪdɪ/	опрятный, аккуратный; салфеточка (на спинке мягкой мебели, на столе)
toss	/tɒs/	толчок; бросать, кидать
towel	/'tauəl/	полотенце; вытирать(ся) полотенцем
trade-off		компромисс, взаимные уступки
ultimate	/'ʌltɪmɪt/	самый отдалённый
unbearable	/ʌn'bɛərəbl/	невыносимый
undergraduate	/,ʌndə'gradjuɪt/	студент
uniformity	/,ju:nɪ'fɒ:mɪtɪ/	единообразие
untidy	/ʌn'taɪdɪ/	неопрятный, неаккуратный
unveil	/ʌn'veɪl/	снимать покрывало (с чего-л.)
urge	/ə:dʒ/	толчок, побуждение; побуждать
velocity	/vɪ'lɒsitɪ/	скорость
wage	/weɪdʒ/	заработная плата; вести (войну)
waist	/weɪst/	талия
wand	/wɒnd/	прут, палочка
wasteful	/'weɪstful/	расточительный
withdraw	/wɪð'drɒ:/	отдёргивать
yank	/jaŋk/	янки
yield	/ji:ld/	сбор плодов, урожай; производить, приносить, давать (плоды, урожай, доход)
