abrupt	/ə'brʌpt/	обрывистый, крутой
abyss	/ə'bɪs/	бездна, пропасть
accommodate	/ə'kɒmədeɪt/	приспосабливать
admission	/əd'mɪʃ(ə)n/	доступ
agenda	/ə'dʒendə/	повестка дня
agile	/'adʒaɪl/	проворный
apprentice	/ə'prentɪs/	ученик, подмастерье; отдавать в учение
assert	/ə'sə:t/	утверждать
assess	/ə'ses/	определять сумму налога, штрафа и т. п.
attain	/ə'teɪn/	достигнуть, добиться
backlog	/'baklɒg/	задолженность
beverage	/'bevərɪdʒ/	напиток
bond	/bɒnd/	связь, узы; связывать; крепостной (крестьянин); крепостной
bound	/baund/	граница, предел; ограничивать; прыжок, скачок; прыгать, скакать; связанный; готовый (особ. к отправлению)
canvas	/'kanvəs/	холст, парусина
cart	/ka:t/	телега; ехать, везти в телеге
clap	/klap/	хлопанье; хлопать, аплодировать; триппер; заразить триппером
clip	/klɪp/	зажимные клещи; зажимать, сжимать, крепко обхватывать; стрижка; стричь (особ. овец); быстрая походка; быстро идти, бежать
coarse	/kɒ:s/	грубый (о пище, одежде и т. п.)
collateral	/kɒ'latərəl/	побочный, второстепенный; родство или родственник по боковой линии
commute	/kə'mju:t/	заменять
compel	/kəm'pel/	заставлять, принуждать
compliance	/kəm'plaɪəns/	согласие
complication	/,kɒmplɪ'keɪʃən/	сложность
conceive	/kən'si:v/	постигать, понимать
consumption	/kəˈnsəmpʃən	kəˈnsəmʃən/	потребление
contemplation	/,kɒntem'pleɪʃən/	созерцание
controversy	/'kɒntrəvə:sɪ/	спор, ссора
conviction	/kən'vɪkʃən/	осуждение, признание виновным
dense	/dens/	плотный
depart	/dɪ'pa:t/	уходить
dignity	/'dɪgnɪtɪ/	достоинство
disguise	/dɪs'gaɪz/	маскировка; переодевать
disrupt	/dɪs'rʌpt/	подрывать
disruption	/dɪs'rʌpʃən/	разрушение
disruptive	/dɪs'rʌptɪv/	разрушительный
divergence	/daɪ'və:dʒəns/	расхождение
drastically	/ˈdræstɑkli/	радикально
excerpt	/'eksə:pt/	отрывок, выдержка; выбирать (отрывки), делать выдержки, подбирать цитаты
excess	/ɪk'ses/	избыток, излишек
excessive	/ɪk'sesɪv/	чрезмерный
exhale	/eks'heɪl/	выдыхать
exile	/'eksaɪl/	изгнание; изгонять
expend	/ɪks'pend/	тратить (on), расходовать
facilitate	/fə'sɪlɪteɪt/	облегчать
fasten	/'fa:sn/	навязывать
fatigue	/fə'ti:g/	усталость, утомление; утомлять, изнурять
fidelity	/fɪ'delɪtɪ/	верность, преданность, лояльность
flee	/fli:/	избегать
gossip	/'gɒsɪp/	болтовня; болтать
gradient	/'greɪdjənt/	уклон, скат
harness	/'ha:nɪs/	упряжь, сбруя; запрягать
humiliation	/hju(:),mɪlɪ'eɪʃən/	унижение
humility	/hju(:)'mɪlɪtɪ/	покорность, смирение
implication	/,ɪmplɪ'keɪʃən/	вовлечение
impose	/ɪm'pəuz/	навязать(ся)
ingenious	/ɪn'dʒi:njəs/	изобретательный, искусный
ingenuity	/,ɪndʒɪ'nju(:)ɪtɪ/	изобретательность, искусность, мастерство
inhabit	/ɪn'habɪt/	жить, обитать, населять
inherent	/ɪn'hɪərənt/	присущий, неотъемлемый
inhibit	/ɪn'hɪbɪt/	препятствовать, сдерживать, подавлять
intervene	/,ɪntə(:)'vi:n/	вмешиваться
jeopardize	/'dʒepədaɪz/	подвергать опасности, рисковать
marble	/'ma:bl/	мрамор; расписывать под мрамор
mill	/mɪl/	мельница; молоть; тысячная часть доллара
mindful	/'maɪndful/	внимательный, помнящий
mistress	/'mɪstrɪs/	хозяйка (дома)
mitigation	/,mɪtɪ'geɪʃən/	смягчение, уменьшение
mob	/mɒb/	толпа, сборище; толпиться
novelty	/'nɒvəltɪ/	новизна
objection	/əb'dʒekʃən/	возражение, протест
obsess	/əb'ses/	завладеть, преследовать, мучить (о навязчивой идее и т. п.)
offspring	/'ɒfsprɪŋ/	отпрыск, потомок
orient	/'ɒ:rɪənt/	Восток, страны Востока; восточный; ориентировать
outward	/'autwəd/	внешний, наружный; внешний вид, внешность
persuade	/pə'sweɪd/	склонить, уговорить (into)
persuasion	/pə'sweɪʒən/	убеждение
ploy	/plɒɪ/	уловка, хитрость
prohibit	/prə'hɪbɪt/	запрещать
remedy	/'remɪdɪ/	средство от болезни, лекарство; исправлять
rigorous	/'rɪgərəs/	суровый
shallow	/'ʃaləu/	мелкий; мелкое место, мель; мелеть
sidewalk	/'saɪdwɒ:k/	тротуар
sincerity	/sɪn'serɪtɪ/	искренность
snoop	/snu:p/	человек, вечно сующий нос в чужие дела; совать нос в чужие дела
sophisticate	/sə'fɪstɪkeɪt/	извращать, фальсифицировать, подделывать
sore	/sɒ:/	болячка, рана, язва; чувствительный, болезненный; жестоко, тяжко
stem	/stem/	ствол; чистить ягоды; запруживать
strive	/straɪv/	стараться
superficial	/,sju:pə'fɪʃəl/	поверхностный, неглубокий, внешний
superlative	/sju(:)'pə:lətɪv/	величайший, высочайший; вершина, кульминация, высшая точка
supervision	/,sju:pə'vɪʒən/	надзор, наблюдение
thorough	/'θʌrə/	полный, совершенный
tissue	/'tɪʃu:/	ткань (особ. тонкая, прозрачная)
vest	/vest/	жилет; облекать
vogue	/vəug/	мода
warehouse	/'wɛəhaus/	товарный склад; помещать в склад